1111111111111111111111111
1000000000001000000000001
1011111111101111111111101
1000000000000000000000001
1011111111011111011111101
1000000001000001000000001
1111111111011111011111111
1000000000001000000000001
1111111111111111111111111