11111111111111111111
10010000000000000001
10000111111011111001
10000100001000001001
11110111100011101011
10000100000010000001
10000111111111111001
10000000000000000001
11111111111111111111