

WE ./path_we

     EA      ./path_ea      
SO ./path_so


F     1,251,255

                   NO       ./path_no
	C  0,0,0


11111111111 1111111
10001 100011111111 
10N0111110000000011
111111111110000111
1         111111

