

WE       ./path_we

     EA      ./path_ea      
SO ./path_so


F     1,251,255

                   NO       ./path_no
	C  0,0,0


11111111111011111
10000 00001111111
10N011111   1  11
11111111111     1
11111
11111111111111111
