

WE       ./path_we

     EA      ./path_ea      
SO ./path_so





F     0,255,255


                   NO       ./path_no
	C  0,0,0


11111111111
10000S00001
10001111001   
11111111111




    