

WE       ./path_we

     EA      ./path_ea      
SO ./path_so


F     1,251,255


                   NO       ./path_no
	C  0,0,0


11111111111
10000 00001
10N011111   
11111111111




    