NO ./textures/hallo1.png
SO ./textures/hallo1.png
WE ./textures/hallo2.png
EA ./textures/hallo2.png
DC ./textures/closed_door.png
DO ./textures/open_door.png
C 19,22,23
F 255,0,255

1111111111111111
1000000100000001
1000000200000001
1000001111000001
10E0003020000001
1000001110000001
1000000200000001
1000000100000001
1111111111111111