NO ./textures/hallo1.png
SO ./textures/hallo1.png
WE ./textures/hallo2.png
EA ./textures/hallo2.png
DC ./textures/closed_door.png
DO ./textures/open_door.png
S  ./textures/e.png
C 19,22,23
F 8,8,7

        1111111111111111111111111
        1000000000000000000000001
        101100000112100012100W001
        1001000000000000111000001
111111111011000001110000000000001
100000000011000001110111111111111
11110111111111011100000010001
11110111111111011101010010001
11000000110101011100000010001
10000000000000001100000010001
1000&000000000001101010010001
1100000111010101111101111000111
11110111 1110101 101111010001
11111111 1111111 111111111111